OOOOOOOO
OOOOOOOO
OHOEOOrO
OOOOOOOO
OOOOOOOO
OeOcOORO
OOeOOOOO
OOOOOOOO