OOOOOOOO
OOOOOOOO
OHOOOOrO
OOOOOOOO
OOOOOOOO
OhOOOORO
OOOOOOOO
OOOOOOOO