OOOOOOOO
OOOOOOOO
OHOCOOrO
OOOOOOOO
OOOOOOOO
OeOcOORO
OOeOOOOO
OOOOOOOO