RRORRRRR
CCDDHHOE
OOOOOOOO
OOROOOLO
OrOOhOOO
OOOOOOOO
ccddOhle
rOrrrrrr