OOOOOOOO
OOOOOOOO
OHOOOORO
OOOOOOOO
OOOOOOOO
OhOOOOrO
OOOOOOOO
OOOOOOOO